11111111111111111111111111111111111111111111111111
10000000000000000000000000010000000000000000000001
10000000000000000000000000010000000000010000000001
11111111111111000000000000010000000000010000000001
1000000000000000000000000001$000000000010000000001
10000000000000000000000000011111111111110000000001
10000000000000000000000000000000000100000000000001
10000000000000000111111000000000000100000000000001
10000000000000000100001000000000000100000000000001
10000000000000000100001000000000000100000000000001
10000000111111111100001000000000000000000000000001
10000000100000000000001000000000000111111100000001
10000000100001111100001000000000000100000100000001
10000000000000000000001000000000000100000000000001
11111111111111111111111111111111111111111111111111
