1111111111
1000000001
1000000001
1000000001
1111111001
1000000001
1000000001
1000000001
1001111101
1001000101
1001000101
1001000101
1001011101
1001000001
1111111111